
F 51,51,51

C 19,51,55

NO ./texture/north.xpm

SO ./texture/south.xpm


WE ./texture/west.xpm



EA ./texture/east.xpm




1111111
10S0101
1111111
