NO ./texture/N_Vinelike_Pattern.xpm
SO ./texture/S_Wooden_Floor_Horizontal.xpm
WE ./texture/W_Magma_Floor.xpm
EA ./texture/E_Brick_Wall.xpm

F 220,100,0
C 225,30,0

1111111
1000101
1E00101
1000001
1111111