NO ./texture/north.xpm
SO ./texture/south.xpm
WE ./texture/west.xpm
EA ./texture/east.xpm

F 51,51,51
C 19,51,55

1111111
1000101
1111111
1111111
1S00101
1000001
1000001
1111111