
C 19,51,55
F 51,51,51

NO ./texture/north.xpm
SO ./texture/south.xpm



WE ./texture/west.xpm

EA ./texture/east.xpm





        1111111111111111111111111
        1000000000110000000000001
        1011000001110000000000001
        1001000000000000000000001
        1111111111111111111111111
11111111101100000111000000N0000N1
100000000011000001110111111111111
11110111111111011100000010001
11110111111111011101010010001
11000000110101011100000010001
10000000000000001100000010001
10000000000000001101010010001
1100000111010101111101111000111
111111111 1111111 11111111111